+---+---+---+---+
|   |           |
+   +   +   +   +
|   |   |   |   |
+   +   +   +   +
|   |   |   |   |
+   +   +---+   +
|               |
+---+---+---+---+