+---+---+---+---+
|   |           |
+   +   +   +   +
|   |   |   |   |
+   +   +   +   +
|   |   |       |
+   +   +   +   +
|       |       |
+---+---+---+---+